[followings]
ladygaga=Lady嘎嘎
KimKardashian=卡戴珊
justinbieber=贾斯汀比伯
nprpolitics=NPR政治新闻
rihanna=蕾哈娜
shakira=夏奇拉
AP=美联社
katyperry=凯蒂佩丽
ParisHilton=帕丽斯希尔顿
TIME=时代周刊
jtimberlake=贾斯汀·汀布莱克
nytimes=纽约时报
britneyspears=布兰妮
TomCruise=汤姆克鲁斯
victoriabeckham=维多利亚
CNN=CNN
Oprah=欧普拉
Pink=P!nk
taylorswift13=泰勒·斯威夫特
tedtalks=TED演讲
aplusk=阿什顿·库彻
coldplay=酷玩乐队
Cristiano=C罗
toptweets=TOP推文
KAKA=卡卡
DwyaneWade=韦德
KingJames=詹姆斯
Reuters=路透社
SHAQ=奥尼尔
BarackObama=奥巴马
whitehouse=白宫
